NO	sprite/NORTH_WALL.xpm
SO	sprite/SOUTH_WALL.xpm
WE	sprite/WEST_WALL.xpm
EA	sprite/EAST_WALL.xpm
F	255,121,0
C	29,59,128



111111111111
  1000000E11
11111111111