NO                	sprite/NORTH_WALL.xpm
SO	sprite/SOUTH_WALL.xpm






WE	sprite/WEST_WALL.xpm
EA	sprite/EAST_WALL.xpm
F               	251,121,0
C	0,0,0



111111111111
  100PE0011
11111111111


111111111111
  100P00011
11111111111


